111111
100001
100EP1
0C0001
111111
