111111
100001
10C001
10E001
1P00X1
111111
