111111
100001
100EP0
1C0001
111111
