111111
100001
000EP1
1C0001
111111
