111111
1P0001
100EP1
1C0001
111111
