111111
100001
100001
10E001
1P0001
111111
