111111111111111111111111111111111111111111111
100000000000000L00000000000000000000000000001
1001001010101000101000101C010L010010010101001
1P00010010C1010010C01L01CL00CL01C0100010001E1
100101001C00100001010100000C101001101C1000101
100000000000000L00000000000000000LL0000C00001
111111111111111111111111111111111111111111111
