111111
100001
1000E1
10C001
1P0001
111111
