111111111
100001111
1E00E0001
10C00C001
1P000C101
111111111
