111111
100001
1C00E1
10C001
10P001
111111
