11111111111
10000111101
1000E0001C1
10C00C001C1
1P000C10101
11111111101
1CCCC000001
10000000001
11111CC0001
10001100C01
10101010101
1C1C1C1C1C1
10000000001
11111111111
