11111111111
10000111101
1000E0001C1
10C00C001C1
1P000C10101
1100LLL1101
1CCCC000001
1LL00000001
11111CC0001
10001100C01
10100000101
1C101C1C1C1
1LL000EE001
11111111111
